border_size=1
usage=map

Gs^Fp       , Gs^Fp       , Rd          , Rd          , Rd          , Gs^Fp       , Gs^Fp       , Gs^Fp       , Gs^Fp       , Gs^Fp       , Gs^Fp       , Gs^Fp       , Gs^Fp       , Gs^Fp       , Gs^Fp       , Gs^Fp       , Gs^Fp       , Gs^Fp       , Gs^Fp       , Gs^Fp       , Gs^Fp       , Gs^Fp       , Gs^Fp       , Gs^Fp       , Gs^Fp       , Gs^Fp       , Gs^Fp       , Hd          , Hhd         , Hhd         , Hhd         , Hhd         
Gs^Fp       , Gs^Fp       , Rd          , Rd          , Rd          , Gs^Fp       , Gs^Fp       , Gs^Fp       , Gs^Fp       , Gs^Fp       , Gs^Fp       , Gs^Fp       , Gs^Fp       , Gs^Fp       , Gs^Fp       , Gs^Fp       , Gs^Fp       , Gs^Fp       , Gs^Fp       , Gs^Fp       , Gs^Fp       , Gs^Fp       , Gs^Fp       , Gs^Fp       , Gs^Fp       , Gs^Fp       , Gs^Fp       , Hd          , Hhd         , Hhd         , Hhd         , Hhd         
Gs^Fp       , Gs^Fp       , Rd          , Rd          , Rd          , Rd          , Gs^Fp       , Gs^Fp       , Gg^Ve       , Gs^Fp       , Gs^Fp       , Gs^Fp       , Gs^Fp       , Gs^Fp       , Gs^Fp       , Gs^Fp       , Chr         , Gs^Fp       , Gs^Fp       , Gs^Fp       , Gg^Fet      , Gs^Fp       , Gs^Fp       , Gs^Fp       , Gg^Ve       , Gs^Fp       , Gs^Fp       , Mm          , Hd          , Hhd         , Hhd         , Hhd         
Gs^Fp       , Gs^Fp       , Rd          , Rd          , Rd          , Rd          , Gs^Fp       , Gs^Fp       , Gs^Fp       , Gs^Fp       , Gs^Fp       , Gg^Ve       , Gs^Fp       , Gs^Fp       , Gs^Fp       , Chr         , 3 Kh        , Chr         , Gs^Fp       , Gs^Fp       , Gs^Fp       , Gs^Fp       , Gs^Fp       , Gs^Fp       , Gs^Fp       , Gs^Fp       , Gs^Fp       , Gs^Fp       , Hd          , Hhd         , Hhd         , Hhd         
Gs^Fp       , Gs^Fp       , Rd          , Rd          , Rd          , Rd          , Rd          , Gs^Fp       , Gs^Fp       , Gs^Fp       , Gs^Fp       , Gs^Fp       , Gs^Fp       , Gs^Fp       , Gs^Fp       , Chr         , Chr         , Chr         , Gs^Fp       , Gs^Fp       , Gs^Fp       , Gs^Fp       , Gs^Fp       , Gs^Fp       , Gs^Fp       , Gs^Fp       , Gs^Fp       , Gs^Fp       , Hd          , Hhd         , Hhd         , Hhd         
Gs^Fp       , Gs^Fp       , Gs^Fp       , Rd          , Rd          , Rd          , Rd          , Gs^Fp       , Gs^Fp       , Gg^Fet      , Gs^Fp       , Gs^Fp       , Gs^Fp       , Gs^Fp       , Gs^Fp       , Gs^Fp       , Gs^Fp       , Gs^Fp       , Gs^Fp       , Gs^Fp       , Hh^Vhh      , Gs^Fp       , Gs^Fp       , Gs^Fp       , Gs^Fp       , Gg^Fet      , Gs^Fp       , Gs^Fp       , Hd          , Hd          , Hhd         , Hhd         
Gs^Fp       , Gs^Fp       , Gs^Fp       , Gs^Fp       , Rd          , Rd          , Rd          , Rd          , Rd          , Gs^Fp       , Gs^Fp       , Gg^Ve       , Gs^Fp       , Gs^Fp       , Gs^Fp       , Gs^Fp       , Gs^Fp       , Gs^Fp       , Gs^Fp       , Gs^Fp       , Gs^Fp       , Gs^Fp       , Gs^Fp       , Gs^Fp       , Gs^Fp       , Gs^Fp       , Gs^Fp       , Gs^Fp       , Mm          , Mm          , Hhd         , Hhd         
Gs^Fp       , Gs^Fp       , Gg^Fet      , Gs^Fp       , Gs^Fp       , Rd          , Rd          , Rd          , Rd          , Gs^Fp       , Gs^Fp       , Gs^Fp       , Gs^Fp       , Gs^Fp       , Gs^Fp       , Gs^Fp       , Gs^Fp       , Gs^Fp       , Hd          , Gs^Fp       , Gs^Fp       , Gs^Fp       , Gs^Fp       , Gs^Fp       , Gg^Ve       , Gs^Fp       , Gs^Fp       , Hd          , Hhd         , Mm          , Hhd         , Hhd         
Gs^Fp       , Gs^Fp       , Gs^Fp       , Gs^Fp       , Gs^Fp       , Gs^Fp       , Gs^Fp       , Rd          , Rd          , Rd          , Gs^Fp       , Gs^Fp       , Gs^Fp       , Gs^Fp       , Hh^Fds      , Gs^Fp       , Hh          , Hd          , Hh          , Hd          , Hd          , Gs^Fp       , Gs^Fp       , Gs^Fp       , Gs^Fp       , Gs^Fp       , Gs^Fp       , Mm          , Mm          , Mm          , Hhd         , Hhd         
Gs^Fp       , Gs^Fp       , Gs^Fp       , Gs^Fp       , Gs^Fp       , Gs^Fp       , Gs^Fp       , Rd          , Rd          , Rd          , Rd          , Gs^Fp       , Hh^Fds      , Hh          , Hh          , Hh          , Hh          , Hh          , Hh          , Hh          , Hd          , Gs^Fp       , Gs^Fp       , Gs^Fp       , Gs^Fp       , Gs^Fp       , Gs^Fp       , Hd          , Hhd         , Mm          , Mm          , Mm          
Gs^Fp       , Gs^Fp       , Gg^Ve       , Gs^Fp       , Gs^Fp       , Gs^Fp       , Gs^Fp       , Rd          , Rd          , Rd          , Rd          , Rd          , Rd          , Hh          , Rd          , Hh          , Hh          , Hh          , Hh          , Hh          , Hd          , Gs^Fp       , Gs^Fp       , Gs^Fp       , Gs^Fp       , Gs^Fp       , Hd          , Hd          , Hhd         , Hhd         , Hhd         , Hhd         
Gs^Fp       , Gs^Fp       , Gs^Fp       , Gs^Fp       , Gs^Fp       , Gs^Fp       , Gs^Fp       , Gs^Fp       , Gs^Fp       , Rd          , Rd          , Rd          , Rd          , Rd          , Rd          , Hh          , Hh          , Hh^Fds      , Hh^Fds      , Hh          , Hd          , Gs^Fp       , Gs^Fp       , Gs^Fp       , Gs^Fp       , Gs^Fp       , Hd          , Hhd         , Hd          , Hhd         , Hhd         , Hhd         
Gs^Fp       , Gs^Fp       , Gs^Fp       , Gs^Fp       , Gs^Fp       , Gs^Fp       , Hh^Fp       , Hh          , Hh^Fp       , Hh          , Hd          , Rd          , Rd          , Rd          , Rd          , Rd          , Hh          , Hh^Fds      , Hh          , Hh          , Hh          , Hd          , Hd          , Gs^Fp       , Hh          , Hh^Fds      , Hh          , Hd          , Chr         , Hd          , Hd          , Hhd         
Gs^Fp       , Gs^Fp       , Gs^Fp       , Gs^Fp       , Gs^Fp       , Gs^Fp       , Hh^Fp       , Hh^Vhh      , Hh          , Hh^Fp       , Hd          , Hd          , Hd          , Rd          , Rd          , Rd          , Rd          , Hh          , Hh^Vhh      , Hh          , Hh          , Hh          , Hh          , Hh          , Hh          , Hh          , Hh          , Chr         , 4 Kh        , Chr         , Hd          , Hhd         
Gs^Fp       , Gs^Fp       , Gg^Fet      , Gs^Fp       , Gs^Fp       , Gs^Fp       , Gs^Fp       , Hh^Fp       , Hh          , Hd          , Hhd         , Md          , Hd          , Rd          , Rd          , Rd          , Rd          , Hh          , Hh          , Hh          , Hh^Fds      , Hh          , Hh          , Mm^Vc       , Hh          , Hh          , Hh          , Chr         , Chr         , Chr         , Hd          , Hhd         
Gs^Fp       , Gs^Fp       , Gs^Fp       , Gs^Fp       , Gs^Fp       , Gs^Fp       , Gs^Fp       , Hd          , Hd          , Hd          , Md          , Md          , Md          , Hd          , Rd          , Rd          , Rd          , Hh          , Hh          , Hh          , Hh          , Hh          , Hh          , Hh          , Hh          , Hh          , Hh          , Hh          , Hd          , Hd          , Hd          , Hhd         
Gs^Fp       , Gs^Fp       , Gs^Fp       , Gs^Fp       , Gg^Ve       , Gs^Fp       , Gs^Fp       , Hd          , Hd          , Hhd         , Hd          , Md          , Hhd         , Hd          , Rd          , Rd          , Rd          , Hd          , Hd          , Hh          , Hh          , Hh^Fds      , Hh          , Hh          , Hh          , Hh^Fds      , Hh          , Hh          , Hd          , Mm          , Hhd         , Hd          
Gs^Fp       , Gs^Fp       , Gs^Fp       , Gs^Fp       , Gs^Fp       , Gs^Fp       , Hd          , Hh^Fms      , Hh          , Hd          , Hh          , Hd          , Hd          , Hd          , Rd          , Rd          , Rd          , Hd          , Md          , Hd          , Hd          , Hh          , Hh          , Hh          , Hh          , Hh          , Hh          , Hh          , Hd          , Hd          , Hd          , Hd          
Gs^Fp       , Gs^Fp       , Hhd         , Hd          , Hhd         , Hd          , Hd          , Hd          , Hh          , Hh          , Hh          , Hh          , Rd          , Rd          , Rd          , Rd          , Hd          , Hd          , Hh          , Hd          , Md          , Hd          , Hd          , Hd          , Hd          , Hd          , Hd          , Mm^Vc       , Hh          , Hh          , Hh          , Hh          
Hd^Fds      , Hd          , Chr         , Hd          , Hh          , Hh^Fms      , Hh          , Hh          , Hh          , Hh          , Hh          , Hh          , Rd          , Rd          , Rd          , Rd          , Hh          , Hd          , Hh          , Hd          , Md          , Md          , Hhd         , Md          , Hd          , Hhd         , Hd          , Hh          , Hh          , Hh          , Hh          , Hh          
Chr         , Chr         , 5 Kh        , Chr         , Hh          , Hh          , Hh          , Hh          , Hh^Vhh      , Hh          , Hh          , Rd          , Rd          , Rd          , Hh          , Hd          , Hd          , Hd          , Hd          , Hd          , Hhd         , Md          , Hd          , Hd          , Hh          , Hd          , Hh          , Hh          , Hh          , Md          , Hh          , Hh          
Chr         , Chr         , Chr         , Chr         , Hh          , Hh          , Hh          , Hh          , Hh          , Hh          , Rd          , Rd          , Rd          , Hd          , Hd          , Hh          , Hd          , Md          , Hhd         , Md          , Hd          , Hd          , Hh          , Hh          , Hh          , Hh          , Hh          , Hh          , Hh          , Hh          , Hh          , Hh          
Hh          , Hh          , Hh          , Hh          , Hh          , Hh          , Hh          , Hh          , Hh          , Rd          , Rd          , Rd          , Hd          , Hd          , Md          , Hd          , Md          , Md          , Md          , Hd          , Hh          , Hh          , Hh          , Hh          , Hh          , Hh^Fms      , Hh          , Hh          , Hd          , Hh          , Uu^Vu       , Uu          
Hh          , Hh          , Hh          , Hh          , Hh          , Hh          , Hh          , Hh          , Rd          , Rd          , Rd          , Rd          , Rd          , Hd          , Hd          , Md          , Md          , Hhd         , Hd          , Hd          , Mm^Vc       , Hh          , Hh          , Hh          , Hd          , Hh          , Hh          , Hh          , Hd          , Mm          , Mm          , Mm          
Hh          , Hh          , Hh          , Hh          , Hh^Vhh      , Hh          , Hh          , Hh          , Hh          , Rd          , Rd          , Rd          , Rd          , Rd          , Hd          , Hhd         , Md          , Md          , Hd          , Hh          , Hh          , Hh          , Hd          , Hd          , Md          , Hd          , Hd          , Hd          , Md          , Md          , Md          , Md          
Hh          , Hh          , Hh          , Hh          , Hh          , Hh          , Hh          , Hh          , Mm^Vc       , Hh          , Hh          , Rd          , Rd          , Rd          , Hd          , Md          , Hhd         , Md          , Hd          , Hh          , Hh^Fms      , Hh          , Hd          , Md          , Hhd         , Hhd         , Mm          , Hhd         , Hhd         , Hhd         , Hhd         , Hhd         
Hh^Fdf      , Hh          , Hh          , Hh          , Hh          , Hh          , Hh          , Hh          , Hh          , Hh          , Hh          , Rd          , Rd          , Rd          , Hd          , Hd          , Hd          , Md          , Hd          , Hh          , Hh          , Hh^Fms      , Hd          , Md          , Md          , Mm^Vc       , Hhd         , Mm          , Mm          , Mm          , Mm          , Mm          
Mm          , Mm          , Mm          , Hh          , Hh          , Hh          , Hh          , Mm          , Mm          , Hd          , Hd          , Rd          , Rd          , Rd          , Hd          , Hh^Fms      , Hh^Fms      , Hd          , Rd          , Rd          , Rd          , Hh^Fms      , Hh          , Hd^Fdf      , Md          , Hhd         , Md          , Hhd         , Mm          , Mm          , Mm          , Mm          
Hhd         , Hhd         , Hd          , Hd          , Hh          , Hh          , Hh          , Hh          , Hd          , Hhd         , Hd          , Rd          , Rd          , Rd          , Hhd         , Hhd         , Rd          , Rd          , Rd          , Rd          , Rd          , Rd          , Hh          , Hd          , Md          , Md          , Hd          , Hd^Fdf      , Rd          , Mm          , Rd          , Rd          
Md          , Hd^Fdf      , Hd          , Hd          , Hd          , Hh          , Hh          , Hh          , Hh          , Hd          , Hd          , Rd          , Rd          , Rd          , Hhd         , Hd^Fet      , Rd          , Rd          , Rd          , Rd          , Rd          , Rd          , Rd          , Hd^Fdf      , Hd^Fdf      , Hd^Fdf      , Ce          , Ce          , Ce          , Rd          , Rd          , Rd          
Hhd         , Md          , Md          , Hhd         , Hd          , Hh          , Hh          , Hh          , Hh          , Hd          , Hd          , Rd          , Rd          , Rd          , Rd          , Rd          , Rd          , Rd          , Hd          , Hd          , Rd          , Rd          , Rd          , Rd          , Rd          , Rd          , Ce          , 1 Ke        , Ce          , Rd          , Rd          , Rd          
Md          , Md          , Md          , Hhd         , Hhd         , Hd          , Hh          , Hh^Vhh      , Hh          , Hd          , Hd          , Rd          , Rd          , Rd          , Rd          , Rd          , Rd          , Rd          , Hd          , Hd          , Hd          , Rd          , Rd          , Rd          , Rd          , Rd          , Rd          , Ce          , Hd          , Rd          , Mm          , Mm          
Hhd         , Hhd         , Hd          , Hd          , Md          , Hd          , Hd          , Hh          , Hh          , Hh^Fdf      , Hd          , Hd          , Hd          , Rd          , Rd          , Rd          , Hd          , Hd          , Hd^Fdf      , Hhd         , Hd          , Rd          , Rd          , Rd          , Rd          , Rd          , 2 Hd        , Hd          , Hd^Fdf      , Mm          , Mm          , Mm          
Md          , Hhd         , Hd          , Hh          , Hd          , Hhd         , Hhd         , Hd          , Hd          , Hd          , Md          , Md          , Md          , Hd          , Hd          , Hd          , Hhd         , Hd^Fdf      , Md          , Md          , Hhd         , Hd          , Hd          , Hd          , Hd          , Hd          , Mm          , Mm          , Mm          , Mm          , Mm          , Mm          
Md          , Hhd         , Hhd         , Hh          , Hd          , Md          , Md          , Md          , Hhd         , Hhd         , Hhd         , Md          , Hhd         , Hhd         , Hhd         , Hhd         , Mm          , Hhd         , Hhd         , Hhd         , Hhd         , Md          , Md          , Hd          , Hd^Fdf      , Hhd         , Mm          , Mm          , Mm          , Mm          , Mm          , Mm          
Md          , Md          , Hhd         , Hh          , Hd          , Md          , Md          , Hhd         , Hd          , Hh^Fdf      , Hd          , Hhd         , Mm          , Mm          , Hd          , Mm          , Hd          , Hd          , Mm          , Mm          , Uu^Vu       , Hhd         , Hhd         , Hhd         , Hhd         , Hhd         , Hd^Fdf      , Mm          , Mm          , Uu^Vu       , Mm          , Mm          
Hhd         , Hhd         , Mm^Vc       , Hhd         , Md          , Md          , Md          , Hhd         , Hd          , Uu^Vu       , Uu^Vu       , Mm          , Hd          , Hd          , Hhd         , Hd          , Hd          , Hhd         , Hd          , Mm          , Mm          , Mm          , Mm          , Hhd         , Md          , Md          , Hhd         , Mm          , Mm          , Mm          , Mm          , Mm          
Md          , Hhd         , Md          , Md          , Hhd         , Mm          , Hhd         , Hhd         , Hhd         , Hd          , Md          , Hd          , Mm          , Hhd         , Hh^Fdf      , Hhd         , Hh^Fdf      , Hhd         , Hhd         , Hd          , Hhd         , Mm          , Hd          , Hd          , Md          , Md          , Hhd         , Hhd         , Mm          , Mm          , Mm          , Mm          
Md          , Hhd         , Md          , Md          , Chr         , Chr         , Chr         , Hhd         , Md          , Hhd         , Md          , Hd          , Mm          , Hd          , Hhd         , Hd          , Hhd         , Hhd         , Hhd         , Hhd         , Mm          , Mm          , Hhd         , Hhd         , Hhd         , Hhd         , Mm          , Mm          , Mm          , Mm          , Mm          , Mm          
Md          , Md          , Md          , Hhd         , Chr         , 6 Kh        , Chr         , Hhd         , Md          , Hhd         , Hhd         , Hd          , Hd          , Mm^Vc       , Hd          , Hhd         , Md          , Hhd         , Mm          , Hd          , Hd          , Hd          , Mm          , Mm          , Mm          , Mm          , Mm          , Mm          , Mm          , Mm          , Mm          , Mm          
Md          , Md          , Md          , Md          , Hd          , Chr         , Hd          , Hhd         , Md          , Md          , Md          , Mm          , Hhd         , Hd          , Hhd         , Md          , Md          , Hd          , Mm          , Mm          , Mm          , Mm          , Mm          , Mm          , Mm          , Mm          , Mm          , Mm          , Mm          , Mm          , Mm          , Mm          
Md          , Hhd         , Hhd         , Hhd         , Hd          , Chr         , Hd          , Hhd         , Hhd         , Hhd         , Hhd         , Hhd         , Md          , Md          , Md          , Hhd         , Hhd         , Hd          , Mm          , Mm          , Mm          , Mm          , Mm          , Mm          , Mm          , Mm          , Mm          , Mm          , Mm          , Mm          , Mm          , Mm          
