border_size=1
usage=map

Md          , Md          , Hhd         , Md          , Hhd         , Hd          , Hd          , Rd          , Rd          , Rd          , Hd          , Md          , Md          , Md          , Uu          , Md          , Md          , Hhd         , Md          , Md          , Hhd         , Md          , Md^Xm       , Md^Xm       , Md^Xm       , Md^Xm       , Uu          , Hhd         , Md          , Md          , Md          , Md          
Md          , Md          , Md          , Md          , Md          , Md          , Hd          , Rd          , Rd          , Rd          , Hd          , Hhd         , Hd          , Md          , Uu^Vu       , Hhd         , Md          , Hhd         , Md          , Md          , Md          , Md          , Hhd         , Md^Xm       , Md^Xm       , Hhd         , Uu^Vu       , Hhd         , Md          , Md          , Md          , Md          
Md          , Md          , Md          , Hhd         , Md          , Hhd         , Hd          , Rd          , Rd          , Rd          , Rd          , Hd          , Rd          , Hd          , Md          , Md          , Md          , Md          , Md          , Md          , Md          , Md          , Md^Xm       , Md^Xm       , Hd          , Hhd         , Hd          , Hhd         , Hhd         , Md          , Md          , Md          
Md          , Md          , Md          , Md          , Uu^Vu       , Md          , Md          , Hd          , Hd          , Rd          , Rd          , Rd          , Rd          , Hd          , Md          , Hhd         , Hhd         , Md          , Md          , Hhd         , Hd          , Hhd         , Hd          , Md^Xm       , Re          , Hd          , Re          , Hd          , Hd          , Md          , Hhd         , Hhd         
Md          , Md          , Hhd         , Md          , Hhd         , Md          , Md          , Md          , Md          , Hd          , Hd          , Rd          , Rd          , Hd          , Hd          , Hd          , Hd          , Hd          , Hd          , Hhd         , Hd          , Re          , Hd          , Md^Xm       , Re          , Re          , Hhd         , Re          , Hd          , Hhd         , Uu^Vu       , Uu          
Md          , Md          , Md          , Md          , Mm          , Hhd         , Mm          , Md          , Mm          , Hhd         , Ds          , Rd          , Rd          , Rd          , Rd          , Re          , Re          , Re          , Re          , Hd          , Re          , Re          , Re          , Hd          , Re          , Md^Xm       , Md          , Re          , Re          , Hd          , Hd          , Hhd         
Md          , Md          , Mm^Xm       , Mm^Xm       , Mm          , Mm^Xm       , Mm^Xm       , Mm^Xm       , Mm^Xm       , Mm          , Rd          , Rd          , Rd          , Rd          , Hh          , Mm          , Mm          , Mm          , Mm          , Re          , Re          , Re          , Re          , Re          , Mm          , Mm^Xm       , Hd          , Hhd         , Hd          , Re          , Hd          , Md          
Mm          , Mm^Xm       , Mm^Xm       , Mm^Xm       , Mm^Xm       , Mm          , Mm^Xm       , Mm^Xm       , Mm          , Mm          , Rd          , Rd          , Rd          , Hh          , Mm          , Mm          , Mm          , Mm          , Mm          , Mm          , Mm          , Mm          , Hh          , Mm          , Ha          , Mm^Xm       , Ai          , Hd          , Ha^Vhha     , Re          , Hd          , Md          
Mm          , Mm^Xm       , Mm^Xm       , Mm^Xm       , Mm          , Mm          , Mm^Xm       , Mm          , Hh          , Rd          , Rd          , Rd          , Rd          , Hh          , Mm          , Mm          , Mm          , Mm          , Mm          , Mm          , Ms          , Mm          , Mm          , Mm          , Mm          , Mm^Xm       , Ha          , Ha          , Re          , Re          , Ha          , Ha          
Mm          , Mm^Xm       , Mm          , Mm^Xm       , Mm          , Mm          , Mm          , Mm          , Ai          , Rd          , Rd          , Rd          , Rd          , Ha^Vhha     , Ha          , Mm          , Ha          , Ms          , Ms          , Ms          , Ms          , Ms          , Ms          , Mm          , Ms          , Mm^Xm       , Mm^Xm       , Re          , Ha          , Ha          , Ha^Vhha     , Ha          
Mm^Xm       , Mm^Xm       , Mm^Xm       , Mm          , Uu^Vu       , Mm          , Mm          , Mm          , Ai          , Rd          , Rd          , Rd          , Rd          , Ha          , Ha          , Ha          , Ha          , Ha          , Ha          , Ha          , Ha          , Ms          , Ha          , Ms          , Ms          , Ms          , Ha          , Mm^Xm       , Mm^Xm       , Ha          , Mm          , Mm          
Mm^Xm       , Mm          , Mm          , Mm          , Mm          , Mm          , Mm          , Mm          , Ai          , Ha          , Rd          , Rd          , Rd          , Rd          , Rd          , Ha          , Rd          , Rd          , Rd          , Ha          , Ha          , Ha          , Ha          , Ha          , Ha          , Ha          , Ha          , Ha          , Ai          , Mm^Xm       , Mm^Xm       , Mm^Xm       
Uu          , Uu^Vu       , Mm          , Mm          , Mm          , Mm          , Mm          , Mm          , Mm          , Ha          , Ha          , Rd          , Rd          , Rd          , Rd          , Rd          , Rd          , Rd          , Rd          , Rd          , Ha          , Ha          , Ha          , Ha          , Aa^Vha      , Ha          , Ai          , Ai          , Ha          , Ms          , Ms          , Mm          
Mm          , Mm          , Mm          , Mm          , Chr         , Chr         , Chr         , Mm          , Mm          , Mm          , Re          , Ha          , Ha          , Rd          , Rd          , Rd          , Rd          , Rd          , Rd          , Rd          , Rd          , Ha          , Ha          , Ha          , Ms          , Ha          , Ha          , Ha          , Ha          , Ha          , Ha          , Ha          
Ms          , Mm          , Mm          , Mm          , Chr         , 4 Kh        , Chr         , Mm          , Mm          , Mm          , Ha          , Ha          , Ha          , Ha          , Ha          , Ha          , Ha          , Ha          , Rd          , Rd          , Rd          , Ha          , Ha          , Ms          , Ms          , Ms          , Ha          , Ha          , Ha          , Ha          , Ha          , Ha          
Mm          , Mm          , Mm          , Mm          , Mm          , Chr         , Mm          , Mm          , Ha          , Ha          , Ha          , Ha          , Ha          , Ha          , Ha          , Re          , Ha          , Ha          , Rd          , Rd          , Rd          , Ha          , Ha          , Ms          , Ms          , Ms          , Ms          , Ms          , Ms          , Ms          , Ms          , Ms          
Mm          , Mm          , Uu^Vu       , Mm          , Mm          , Mm          , Ha          , Ha          , Ha          , Ha          , Ha          , Ha^Vca      , Ha          , Ha^Vca      , Ha          , Ha          , Ha          , Ha          , Rd          , Rd          , Rd          , Ha          , Aa^Vha      , Ms          , Ms          , Ms          , Ms          , Ms          , Ms          , Ms          , Ms          , Ms          
Ms          , Ms          , Ms          , Mm          , Ha          , Ha          , Ha          , Ha^Vca      , Ha          , Ha          , Ha          , Ha          , Ha          , Ha          , Rd          , Rd          , Rd          , Rd          , Rd          , Rd          , Rd          , Ha          , Ha          , Ha          , Ai          , Ai          , Ms          , Ms          , Ms          , Ms          , Ha          , Ha          
Ms          , Ms          , Ms          , Ha          , Ha          , Ha          , Ha          , Ha          , Aa          , Ha          , Ha          , Ha          , Rd          , Rd          , Rd          , Rd          , Rd          , Rd          , Rd          , Rd          , Ha          , Ha          , Ha          , Ai          , Ha          , Ms          , Ms          , Ms          , Ms          , Ms          , Ai          , Ai          
Ms          , Ms          , Ms          , Ha          , Ha          , Ha          , Ha          , Ha          , Ha          , Ha          , Ha          , Rd          , Rd          , Rd          , Rd          , Rd          , Ha          , Rd          , Ha          , Ha          , Ha          , Ha          , Ha          , Ha          , Ms          , Ms          , Ms          , Ha^Voa      , Ms          , Ms          , Ha          , Ha          
Ms          , Ms          , Ha          , Ha          , Ha          , Aa          , Aa          , Ha          , Ha          , Ha          , Rd          , Rd          , Rd          , Rd          , Rd          , Rd          , Rd          , Ha          , Ha          , Ha^Vca      , Ha          , Ha          , Ha          , Ha          , Ms          , Ms          , Ms          , Ms          , Ai          , Ai          , Ai          , Ai          
Ms          , Ms          , Ms          , Ha          , Ha^Vca      , Ha          , Aa          , Ha          , Ha          , Ha          , Rd          , Rd          , Rd          , Rd          , Rd          , Rd          , Rd          , Rd          , Rd          , Ha          , Rd          , Ha          , Ha          , Ha          , Ha          , Ms          , Chr         , Chr         , Chr         , Ha          , Ha          , Ha          
Ms          , Ms          , Ms          , Ms          , Ha          , Ha          , Ha          , Ha          , Ms          , Ha          , Ha          , Rd          , Ha          , Rd          , Ha          , Rd          , Rd          , Rd          , Rd          , Rd          , Rd          , Rd          , Rd          , Ha          , Ha          , Ha          , Chr         , 3 Kh        , Chr         , Ha          , Ha          , Ha          
Ms          , Ms          , Ms          , Ms          , Ha          , Ha          , Ms          , Ms          , Ms          , Ms          , Ha          , Ha          , Ha          , Ha          , Ha          , Ha          , Ha          , Rd          , Rd          , Rd          , Rd          , Rd          , Rd          , Ha          , Ha          , Ha          , Ha          , Chr         , Ha          , Ha          , Aa          , Ha          
Ha          , Ha          , Ms          , Ha          , Ms          , Ai          , Ms          , Ms          , Ms          , Ms          , Ms          , Ha          , Ha          , Ha          , Ha          , Aa          , Ha          , Ha          , Ha          , Rd          , Rd          , Rd          , Rd          , Rd          , Ha          , Ha          , Ha          , Ha          , Ha          , Ha          , Ha          , Ha          
Ms          , Ms          , Ms          , Ms          , Ms          , Ms          , Ha          , Ms          , Ms          , Ms          , Ms          , Ms          , Ms          , Ms          , Ms          , Ha          , Ha          , Ha          , Ha^Vca      , Ha          , Rd          , Rd          , Rd          , Rd          , Ha          , Ha          , Ha          , Ha          , Ha          , Ha          , Ha          , Ha          
Ms          , Ms          , Ms          , Ms          , Ms          , Ms          , Ha          , Ms          , Ms          , Ms          , Ms          , Ms          , Ms          , Ms          , Ms          , Ha          , Ha          , Ha          , Ha          , Ha          , Ha          , Rd          , Rd          , Rd          , Re          , Ha          , Aa          , Ha          , Ha^Vhha     , Ha          , Ha          , Ha          
Ha          , Ha          , Ai          , Ha          , Ai          , Ha          , Ha          , Ha^Vca      , Ha          , Ha          , Ms          , Ms          , Ms          , Ms          , Ms          , Ms          , Ms          , Ha          , Ha          , Ha          , Ha          , Rd          , Rd          , Rd          , Rd          , Ha          , Ha          , Ha          , Ha          , Ha          , Ha          , Ha          
Ha          , Ha          , Ai          , Ha          , Ha          , Ai          , Ha          , Ha          , Ha          , Ms          , Ms          , Ms          , Ha          , Ms          , Ms          , Ms          , Ms          , Ha          , Ai          , Ha^Vhha     , Ha          , Rd          , Rd          , Rd          , Ce          , Ce          , Ce          , Ha          , Ha          , Ha          , Ha          , Ha          
Ha          , Ha          , Ha          , Ha          , Ha          , Ha          , Ha          , Ha          , Ha          , Ms          , Ms          , Ms          , Ha          , Ha          , Ha          , Ms          , Ha          , Ha          , Ai          , Ha          , Aa          , Ha          , 2 Ha        , Rd          , Ce          , 1 Ke        , Ce          , Rd          , Ai          , Ha          , Ha          , Ha          
Ha          , Ha          , Ha          , Ha^Vca      , Ha          , Ai          , Ha          , Ai          , Ai          , Ai          , Ha          , Ha          , Ha          , Ha          , Ha          , Ai          , Ai          , Ai          , Ha          , Ha          , Ha          , Ha          , Ai          , Ai          , Ai          , Ce          , Rd          , Rd          , Rd          , Ai          , Ha          , Ha          
Ha          , Ha          , Ha          , Aa          , Ha          , Ai          , Ha          , Ai          , Ai          , Ai          , Ha          , Ha          , Ha          , Ha          , Ha          , Ai          , Ai          , Ai          , Ha          , Ha          , Ha          , Ha          , Ai          , Ai          , Ai          , Ce          , Rd          , Rd          , Rd          , Ai          , Ha          , Ha          
