border_size=1
usage=map

    Gs^Fp,    Gs^Fp,    Gs^Fp,    Gs^Fp,    Gs^Fp,    Gs^Fp,       Gg,       Gg,       Gg,       Gg,       Gg,       Gg,       Gg,       Gg,       Gg,       Gg,       Gg,       Gg,    Gs^Fp,    Gs^Fp,    Gs^Fp,       Gg,       Gg,       Gg,       Gg,       Gg,       Gg,       Gg,       Gg,       Gg,       Gg,    Gs^Fp,    Gs^Fp,    Gs^Fp,    Gs^Fp,    Gs^Fp,    Gs^Fp,    Gs^Fp,    Gs^Fp,    Gs^Fp,    Gs^Fp,       Gg,       Rr,       Rr,    Gs^Fp,    Gs^Fp
    Gs^Fp,    Gs^Fp,    Gs^Fp,    Gs^Fp,    Gs^Fp,    Gs^Fp,       Gg,       Gg,       Gg,       Gg,       Gg,       Gg,       Gg,       Gg,       Gg,       Gg,       Gg,       Gg,    Gs^Fp,    Gs^Fp,    Gs^Fp,       Gg,       Gg,       Gg,       Gg,       Gg,       Gg,       Gg,       Gg,       Gg,       Gg,    Gs^Fp,    Gs^Fp,    Gs^Fp,    Gs^Fp,    Gs^Fp,    Gs^Fp,    Gs^Fp,    Gs^Fp,    Gs^Fp,    Gs^Fp,       Gg,       Rr,       Rr,    Gs^Fp,    Gs^Fp
    Gs^Fp,    Gs^Fp,    Gs^Fp,    Gs^Fp,       Gg,       Gg,       Gg,       Gg,       Gg,       Gg,       Gg,       Gg,       Gg,       Gg,       Gg,    Gg^Vh,       Gg,       Gg,    Gs^Fp,    Gs^Fp,    Gs^Fp,       Gg,       Gg,    Gg^Vh,       Gg,       Gg,       Gg,       Gg,       Gg,       Gg,       Gg,       Gg,       Ww,       Gg,       Ww,       Gg,       Gg,       Gg,    Gg^Vh,       Gg,       Gg,       Rr,    Gs^Fp,    Gs^Fp,    Gs^Fp,    Gs^Fp
    Gs^Fp,    Gs^Fp,    Gs^Fp,       Gg,       Gg,       Gg,       Gg,       Gg,       Gg,       Gg,       Gg,       Gg,       Gg,       Gg,       Ww,    Gg^Vh,       Ww,       Gg,       Rr,    Gs^Fp,       Gg,       Gg,    Gg^Vh,       Gg,       Ww,       Gg,       Ww,       Ww,       Ww,       Ww,       Ww,       Ww,       Ww,       Ww,       Ww,       Ww,       Ww,       Gg,       Gg,       Gg,       Rr,       Rr,       Gg,    Gs^Fp,    Gs^Fp,    Gs^Fp
    Gs^Fp,    Gs^Fp,       Gg,       Gg,       Gg,       Gg,       Gg,       Gg,       Ww,       Ww,       Ww,       Ww,       Ww,       Ww,       Ww,       Ww,       Ww,       Ww,   Ww^Bw|,       Ww,       Ww,       Ww,       Ww,       Ww,       Ww,       Ww,       Ww,       Ww,       Ww,       Ww,       Ww,       Ww,       Wo,       Wo,       Wo,       Ww,       Ww,       Ww,       Rr,       Rr,       Gg,       Gg,       Gg,    Gg^Vh,       Gg,       Gg
       Rr,       Rr,       Rr,       Gg,       Gg,    Gg^Vh,       Ww,       Ww,       Ww,       Ww,       Ww,       Ww,       Ww,       Ww,       Ch,       Ch,       Ww,       Ww,       Rr,       Ww,       Ch,       Ww,       Ww,       Ww,       Wo,       Ww,       Wo,       Ww,       Wo,       Wo,       Wo,       Wo,       Hh,       Ch,       Ch,       Ww,   Ww^Bw/,   Ww^Bw/,       Ww,       Gg,       Ww,    Gg^Vh,       Gg,       Gg,       Gg,       Gg
    Gs^Fp,    Gs^Fp,    Gs^Fp,       Rr,       Rr,       Ww,       Ww,       Ww,       Wo,       Wo,       Ch,       Wo,       Wo,       Wo,    Gg^Vh,       Gg,       Gg,       Gg,       Rr,       Gg,       Gg,       Ch,    Gg^Vh,       Hh,       Hh,       Wo,       Hh,       Wo,       Hh,       Hh,       Hh,       Hh,       Rr,    Gg^Vh,       Rr,       Gg,       Rr,       Ww,       Ww,       Ww,       Ww,       Gg,       Gg,       Gg,    Gs^Fp,    Gs^Fp
    Gg,    Gg^Vh,       Gg,       Gg,       Ww,   Ww^Bw\,   Ww^Bw\,       Ww,       Rr,       Ch,    Gg^Vh,       Hh,       Hh,       Hh,       Gg,       Gg,       Gg,       Gg,       Rr,       Gg,       Gg,       Gg,       Gg,       Gg,       Gg,       Hh,       Rr,       Hh,       Rr,       Rr,       Rr,       Rr,       Gg,       Gg,       Gg,       Rr,       Rr,       Ch,       Ch,       Ww,       Ww,       Gg,       Gg,       Gg,    Gs^Fp,    Gs^Fp
    Gs^Fp,    Gs^Fp,       Gg,    Gg^Vh,       Ww,       Ww,       Rr,       Rr,       Gg,       Rr,       Rr,       Gg,       Rr,       Rr,       Rr,       Rr,       Rr,       Rr,       Rr,       Rr,       Rr,       Gg,       Rr,       Gg,       Rr,       Rr,       Gg,       Rr,       Ch,       Ch,       Gg,       Rr,       Gg,       Ch,       Ch,       Gg,       Rr,       Gg,    Gg^Vh,       Wo,       Ww,       Gg,       Gg,    Gs^Fp,    Gs^Fp,    Gs^Fp
    Gs^Fp,    Gs^Fp,       Gg,       Ww,       Ww,       Ww,       Rr,       Gg,       Gg,       Gg,       Gg,       Rr,       Gg,       Gg,       Gg,       Gg,       Gg,       Gg,       Rr,       Gg,       Gg,       Rr,       Rr,       Rr,    Gs^Fp,       Rr,       Rr,       Gg,       Ch,    Gg^Vh,       Ch,       Ch,       Ch,    Gg^Vh,       Ch,       Gg,       Rr,       Gg,       Hh,       Wo,       Ww,       Gg,       Gg,    Gs^Fp,    Gs^Fp,    Gs^Fp
    Gs^Fp,    Gs^Fp,       Ww,       Ww,       Wo,       Ch,       Rr,       Gg,       Ch,       Ch,       Gg,       Rr,       Gg,       Ch,       Ch,       Gg,       Rr,       Rr,    Gs^Fp,       Rr,       Ce,       Ce,       Rr,    Gs^Fp,    Gs^Fp,    Gs^Fp,       Rr,       Gg,       Gg,       Gg,       Ch,     3 Kh,       Ch,       Gg,       Gg,       Gg,       Rr,       Gg,       Hh,       Wo,       Ww,       Gg,       Gg,       Gg,    Gs^Fp,    Gs^Fp
    Gs^Fp,    Gs^Fp,       Ww,       Wo,       Wo,       Ch,       Rr,       Gg,       Ch,    Gg^Vh,       Ch,       Ch,       Ch,    Gg^Vh,       Ch,       Gg,       Rr,    Gs^Fp,    Gs^Fp,       Rr,       Gg,       Ce,       Rr,    Gs^Fp,    Gs^Fp,    Gs^Fp,       Rr,       Gg,       Rr,       Rr,       Gg,       Ch,       Gg,       Rr,       Rr,       Rr,       Rr,       Gg,       Hh,       Wo,       Wo,       Ww,       Gg,       Gg,    Gs^Fp,    Gs^Fp
       Gg,       Gg,       Ww,       Ww,       Wo,    Gg^Vh,       Rr,       Gg,       Gg,       Gg,       Ch,     2 Kh,       Ch,       Gg,       Gg,       Gg,       Rr,    Gs^Fp,    Gs^Fp,       Rr,       Rr,       Gg,       Rr,       Rr,       Rr,       Rr,       Gg,       Rr,       Gg,       Gg,       Ch,    Gg^Vh,       Ch,       Gg,       Ce,       Gg,       Rr,       Gg,       Gg,       Hh,       Wo,       Ww,       Gg,       Gg,       Gg,       Gg
       Gg,       Gg,       Ww,       Wo,       Wo,       Hh,       Gg,       Rr,       Rr,       Rr,       Gg,       Ch,       Gg,       Rr,       Rr,       Rr,    Gs^Fp,    Gs^Fp,       Rr,       Rr,       Rr,       Rr,       Rr,       Gg,       Gg,       Ce,       Ce,       Rr,       Gg,       Gg,       Gg,       Ch,       Gg,       Gg,       Ce,       Ce,       Rr,       Gg,       Gg,       Hh,       Wo,       Ww,       Gg,       Gg,       Gg,       Gg
       Gg,       Gg,       Ww,       Wo,       Wo,       Hh,       Gg,       Rr,       Gg,       Gg,       Ch,    Gg^Vh,       Ch,       Gg,       Gg,       Rr,       Rr,       Rr,       Gg,       Gg,       Rr,       Gg,       Gg,       Rr,       Rr,       Ce,       Rr,       Rr,       Rr,       Rr,       Rr,       Gg,       Rr,       Gg,       Rr,       Gg,       Rr,       Gg,       Gg,       Hh,       Wo,       Ww,       Gg,       Gg,       Gg,       Gg
       Gg,       Gg,       Ww,       Wo,       Wo,       Hh,       Gg,       Rr,       Gg,       Gg,       Gg,       Ch,       Gg,       Gg,       Rr,       Rr,       Gg,       Gg,       Ww,       Ww,   Ww^Bw|,       Ww,       Ww,       Gg,       Gg,       Rr,       Rr,       Rr,       Gg,       Gg,       Gg,       Rr,    Gs^Fp,       Rr,    Gs^Fp,       Rr,       Rr,       Gg,       Gg,       Hh,       Wo,       Ww,       Gg,       Gg,       Gg,       Gg
       Gg,       Gg,       Ww,       Ww,       Wo,       Hh,       Hh,       Rr,       Rr,       Rr,       Rr,       Gg,       Rr,       Gg,       Rr,       Gg,       Wo,       Ww,       Ch,    Gg^Vh,       Rr,    Gg^Vh,       Ch,       Ww,       Wo,       Gg,       Rr,       Gg,       Ce,       Ce,       Gg,       Rr,    Gs^Fp,    Gs^Fp,    Gs^Fp,    Gs^Fp,       Rr,       Gg,       Hh,       Hh,       Wo,       Ww,       Gg,       Gg,       Gg,       Gg
       Gg,       Gg,       Ww,       Ww,       Wo,       Wo,       Hh,       Gg,       Rr,       Gg,       Ce,       Rr,    Gs^Fp,       Rr,       Rr,       Wo,       Ch,       Ch,       Gg,       Gg,       Rr,       Gg,       Gg,       Ch,       Ch,       Wo,       Rr,       Gg,       Gg,       Ce,       Gg,       Rr,    Gs^Fp,    Gs^Fp,    Gs^Fp,       Rr,       Gg,       Gg,       Hh,       Wo,       Ww,       Ww,       Gg,       Gg,       Gg,       Gg
       Gg,       Gg,       Gg,       Ww,       Wo,       Wo,       Hh,       Gg,       Rr,       Ce,       Ce,       Rr,    Gs^Fp,    Gs^Fp,       Rr,       Wo,       Ch,       Gg,       Gg,       Gg,       Ch,       Gg,       Gg,       Gg,       Ch,       Wo,       Rr,       Rr,       Rr,       Gg,       Rr,       Rr,       Rr,       Rr,       Rr,       Rr,       Gg,    Gg^Vh,       Wo,       Wo,       Ww,       Gg,       Gg,       Gg,       Gg,       Gg
       Gg,       Gg,       Gg,       Ww,       Wo,       Wo,       Hh,       Gg,       Rr,       Gg,       Gg,       Rr,    Gs^Fp,    Gs^Fp,       Rr,       Ww,       Ch,       Gg,       Gg,       Ch,     1 Kh,       Ch,       Gg,       Gg,       Ch,       Ww,       Rr,       Gg,       Ce,       Rr,       Rr,       Gg,       Ce,       Gg,       Rr,       Gg,       Gg,       Ch,       Ww,       Ww,       Gg,       Gg,       Gg,       Gg,       Gg,       Gg
    Gs^Fp,    Gs^Fp,       Ww,       Ww,       Ww,       Wo,    Gg^Vh,       Gg,       Rr,       Gg,       Rr,       Rr,       Rr,       Rr,       Rr,       Ww,    Gg^Vh,       Gg,       Rr,       Ch,       Ch,       Ch,       Rr,       Gg,    Gg^Vh,       Ww,       Rr,       Ce,       Ce,       Gg,       Rr,       Ce,       Ce,       Gg,       Rr,       Gg,       Ww,       Ch,       Ww,       Ww,       Gg,       Gg,       Gg,       Gg,       Gg,       Gg
    Gs^Fp,    Gs^Fp,       Gg,       Ww,       Ww,       Wo,       Ch,       Gg,       Gg,       Rr,       Gg,       Gg,       Gg,       Gg,       Rr,       Ww,   Ww^Bw/,       Rr,       Gg,       Gg,       Gg,       Gg,       Gg,       Rr,   Ww^Bw\,       Ww,       Rr,       Rr,       Rr,       Rr,       Rr,       Rr,       Rr,       Rr,       Rr,       Gg,       Ww,       Ww,       Gg,       Gg,       Gg,    Gg^Vh,       Gg,       Gg,       Gg,       Gg
    Gs^Fp,    Gs^Fp,       Gg,       Gg,       Ww,       Ww,       Ww,       Ch,       Gg,       Rr,       Gg,       Ce,       Ce,       Gg,       Rr,       Rr,       Ww,    Gg^Vh,       Ch,       Gg,       Gg,       Gg,       Ch,    Gg^Vh,       Ww,       Rr,       Rr,       Gg,       Ce,       Gg,       Gg,       Rr,       Gg,       Gg,       Gg,       Rr,   Ww^Bw\,       Gg,       Gg,    Gg^Vh,       Gg,       Gg,       Gg,       Gg,       Gg,       Gg
       Gg,       Gg,       Gg,    Gg^Vh,       Gg,       Ww,       Ww,       Gg,       Gg,       Rr,       Gg,       Ce,       Rr,       Rr,    Gs^Fp,       Rr,       Rr,       Ww,       Ww,       Ch,       Ch,       Ch,       Ww,       Ww,       Rr,       Rr,       Rr,       Gg,       Ce,       Ce,       Gg,       Rr,       Gg,       Gg,       Ch,       Ww,       Ww,       Rr,       Rr,       Gg,    Gs^Fp,       Gg,       Gg,    Gg^Vh,       Gg,       Gg
    Gg,    Gg^Vh,       Gg,       Gg,       Gg,    Gg^Vh,       Ww,       Ww,   Ww^Bw/,       Rr,       Rr,       Rr,       Rr,    Gs^Fp,    Gs^Fp,    Gs^Fp,       Rr,       Rr,       Rr,       Wo,       Wo,       Wo,       Rr,       Rr,       Ce,       Gg,       Gg,       Rr,       Rr,       Gg,       Rr,       Rr,       Gg,       Gg,       Ch,       Ww,       Ww,       Gg,       Gg,    Gs^Fp,    Gs^Fp,    Gs^Fp,       Gg,       Gg,       Gg,       Gg
       Gg,       Gg,    Gs^Fp,       Gg,       Gg,       Gg,       Rr,   Ww^Bw/,       Ww,       Ww,       Ch,       Gg,       Rr,    Gs^Fp,       Rr,       Rr,       Gg,       Gg,       Ce,       Rr,       Rr,       Rr,       Gg,       Gg,       Ce,       Ce,       Rr,       Rr,    Gs^Fp,       Rr,    Gs^Fp,       Rr,       Hh,    Gg^Vh,       Wo,       Ww,       Ww,       Gg,       Gg,    Gs^Fp,    Gs^Fp,    Gs^Fp,       Rr,       Gg,       Gg,       Gg
    Gs^Fp,    Gs^Fp,    Gs^Fp,    Gs^Fp,    Gs^Fp,       Rr,       Gg,       Ww,       Wo,       Ww,       Ch,       Gg,       Rr,       Rr,       Gg,       Rr,       Rr,       Ce,       Ce,       Gg,       Rr,       Gg,       Rr,       Rr,       Rr,       Rr,       Rr,    Gs^Fp,    Gs^Fp,    Gs^Fp,       Rr,       Rr,       Hh,       Wo,       Ww,       Wo,       Ww,       Ww,    Gg^Vh,       Gg,       Gg,       Gg,       Gg,       Rr,       Rr,       Rr
    Gs^Fp,    Gs^Fp,    Gs^Fp,    Gs^Fp,    Gs^Fp,       Gg,       Gg,       Ww,       Wo,       Wo,       Wo,    Gg^Vh,       Gg,       Rr,       Ce,       Ce,       Gg,       Rr,       Rr,       Rr,       Gg,       Rr,       Rr,       Gg,       Gg,       Rr,       Gg,       Rr,       Rr,    Gs^Fp,       Rr,       Gg,       Hh,       Wo,       Ww,       Wo,       Wo,       Ww,       Ww,       Gg,    Gg^Vh,       Gg,       Gg,       Gg,       Gg,       Gg
       Rr,       Rr,    Gs^Fp,    Gs^Fp,       Gg,       Gg,    Gg^Vh,       Ww,       Ww,       Ww,       Wo,       Hh,       Gg,       Rr,       Rr,       Ce,       Rr,       Rr,       Gg,       Gg,       Ch,       Gg,       Rr,       Gg,       Ch,       Gg,       Gg,       Gg,       Gg,       Rr,       Gg,       Hh,       Wo,       Wo,       Ww,       Wo,       Wo,       Wo,       Ww,       Gg,       Gg,       Gg,       Gg,    Gg^Vh,       Gg,       Gg
    Gs^Fp,    Gs^Fp,    Gs^Fp,       Gg,       Gg,       Gg,       Gg,       Gg,       Ww,       Ww,       Wo,       Hh,       Hh,       Gg,       Gg,       Rr,       Gg,       Gg,       Gg,       Ch,    Gg^Vh,       Gg,       Ch,       Gg,    Gg^Vh,       Ch,       Gg,       Gg,       Rr,       Rr,       Hh,       Hh,       Wo,       Ww,       Ww,       Wo,       Wo,       Wo,       Wo,       Ww,       Ww,       Gg,       Gg,       Gg,       Gg,       Gg
    Gs^Fp,    Gs^Fp,       Gg,       Gg,       Gg,       Gg,    Gg^Vh,       Gg,       Ww,       Ww,       Ww,       Wo,       Wo,       Hh,       Gg,       Rr,       Gg,       Gg,       Gg,       Ch,       Gg,       Ch,     4 Kh,       Ch,       Gg,       Ch,       Gg,       Gg,       Rr,       Gg,       Hh,       Wo,       Wo,       Ww,       Ww,       Ww,       Wo,       Wo,       Wo,       Ww,       Ww,       Ww,       Ww,       Gg,       Gg,       Gg
    Gs^Fp,    Gs^Fp,    Gg^Vh,       Gg,       Gg,       Gg,       Gg,       Gg,       Gg,       Ww,       Wo,       Ww,       Wo,       Hh,       Hh,       Rr,       Rr,       Gg,       Gg,       Gg,       Rr,       Ch,       Ch,       Ch,       Rr,       Gg,       Gg,       Rr,       Gg,       Hh,       Wo,       Wo,       Wo,       Wo,       Wo,       Wo,       Wo,       Wo,       Wo,       Wo,       Wo,       Ww,       Ww,       Ww,       Ww,       Ww
       Gg,       Gg,       Gg,       Gg,       Gg,    Gg^Vh,       Gg,       Gg,       Gg,       Ww,       Wo,       Wo,       Wo,       Wo,       Hh,       Gg,       Gg,       Rr,       Rr,       Rr,       Gg,       Gg,    Gg^Vh,       Gg,       Gg,       Rr,       Rr,       Rr,       Gg,       Hh,       Wo,       Wo,       Wo,       Wo,       Wo,       Wo,       Wo,       Wo,       Wo,       Wo,       Wo,       Wo,       Ww,       Ww,       Ww,       Ww
    Gs^Fp,    Gs^Fp,    Gs^Fp,    Gs^Fp,    Gs^Fp,       Gg,       Gg,       Gg,       Gg,       Ww,       Ww,       Ww,       Wo,       Wo,       Wo,       Hh,       Hh,       Gg,       Rr,       Gg,       Gg,       Ch,       Ch,       Ch,       Gg,       Rr,       Gg,       Gg,       Hh,       Hh,       Wo,       Wo,       Wo,       Wo,       Wo,       Wo,       Ww,       Wo,       Wo,       Wo,       Wo,       Wo,       Wo,       Wo,       Ww,       Ww
    Gs^Fp,    Gs^Fp,    Gs^Fp,    Gs^Fp,    Gs^Fp,    Gs^Fp,       Gg,       Gg,       Gg,       Ww,       Ww,       Wo,       Wo,       Wo,       Wo,       Wo,       Wo,    Gg^Vh,       Ch,       Rr,       Rr,       Gg,       Gg,       Gg,       Rr,       Rr,       Ch,    Gg^Vh,       Wo,       Wo,       Wo,       Wo,       Wo,       Wo,       Wo,       Ww,       Wo,       Wo,       Wo,       Ww,       Ww,       Wo,       Wo,       Wo,       Wo,       Wo
    Gs^Fp,    Gs^Fp,    Gs^Fp,    Gs^Fp,       Gg,    Gs^Fp,    Gs^Fp,       Gg,       Gg,       Ww,       Ww,       Ww,       Wo,       Ww,       Ww,       Ww,       Wo,       Wo,       Ww,       Ch,       Gg,       Rr,       Rr,       Rr,       Gg,       Ch,       Wo,       Wo,       Wo,       Wo,       Wo,       Ww,       Ww,       Wo,       Wo,       Wo,       Wo,       Wo,       Ww,       Wo,       Wo,       Wo,       Wo,       Wo,       Wo,       Wo
    Gs^Fp,    Gs^Fp,    Gs^Fp,    Gs^Fp,    Gs^Fp,    Gs^Fp,    Gs^Fp,    Gs^Fp,    Gs^Fp,       Ww,       Ww,       Ww,       Wo,       Ww,       Wo,       Wo,       Wo,       Wo,       Wo,       Ww,       Ww,       Ww,   Ww^Bw|,       Ww,       Wo,       Wo,       Wo,       Wo,       Ww,       Ww,       Wo,       Wo,       Wo,       Wo,       Wo,       Wo,       Wo,       Wo,       Wo,       Wo,       Wo,       Wo,       Wo,       Wo,       Wo,       Wo
    Gs^Fp,    Gs^Fp,    Gs^Fp,    Gs^Fp,    Gs^Fp,    Gs^Fp,    Gs^Fp,    Gs^Fp,       Ww,       Ww,       Wo,       Wo,       Ww,       Wo,       Ww,       Wo,       Ww,       Wo,       Ww,       Wo,       Wo,       Ww,   Ww^Bw|,       Ww,       Ww,       Ww,       Ww,       Ww,       Ww,       Ww,       Ww,       Ww,       Ww,       Wo,       Ww,       Wo,       Ww,       Wo,       Wo,       Wo,       Wo,       Wo,       Wo,       Wo,       Wo,       Wo
    Gs^Fp,    Gs^Fp,    Gs^Fp,    Gs^Fp,    Gs^Fp,    Gs^Fp,       Ww,       Ww,       Ww,       Wo,       Wo,       Wo,       Ss,       Ss,    Gg^Vh,       Gg,       Ww,       Ww,       Ww,       Ww,       Ww,       Ww,   Ww^Bw|,       Ww,       Gg,       Ww,    Gg^Vh,       Gg,       Gg,       Gg,       Gg,       Ww,       Ss,       Ww,       Ss,       Ww,       Ww,       Wo,       Wo,       Wo,       Wo,       Wo,       Wo,       Wo,       Wo,       Wo
    Gs^Fp,    Gs^Fp,    Gs^Fp,    Gs^Fp,       Ww,       Ww,       Wo,       Ww,       Wo,       Wo,       Ww,       Ss,       Ss,       Gg,       Gg,       Gg,       Gg,       Ww,       Gg,       Ww,       Ww,       Ww,       Rr,       Gg,       Gg,       Gg,       Gg,       Gg,       Gg,       Gg,       Gg,       Gg,       Gg,       Ss,       Ss,       Ss,       Ww,       Ww,       Wo,       Wo,       Wo,       Wo,       Wo,       Wo,       Wo,       Wo
    Gs^Fp,    Gs^Fp,    Gs^Fp,       Ww,       Ww,       Wo,       Wo,       Wo,       Wo,       Ww,       Ww,       Ss,       Ss,       Gg,    Gs^Fp,       Gg,       Gg,       Gg,       Gg,       Gg,       Gg,       Gg,       Rr,       Gg,       Gg,       Gg,       Gg,       Gg,       Gg,       Gg,       Gg,       Gg,       Ss,       Ss,       Ss,       Ss,       Ww,       Ww,       Wo,       Wo,       Wo,       Wo,       Wo,       Wo,       Wo,       Wo
    Gs^Fp,    Gs^Fp,    Gs^Fp,       Ww,       Ww,       Wo,       Wo,       Wo,       Wo,       Ww,       Ww,       Ss,       Ss,       Gg,    Gs^Fp,       Gg,       Gg,       Gg,       Gg,       Gg,       Gg,       Gg,       Rr,       Gg,       Gg,       Gg,       Gg,       Gg,       Gg,       Gg,       Gg,       Gg,       Ss,       Ss,       Ss,       Ss,       Ww,       Ww,       Wo,       Wo,       Wo,       Wo,       Wo,       Wo,       Wo,       Wo
